000000000000000000000000000000000
101001101101101010110011110010100
101110001001100110010111010001101
101010011011001101111010110001001
001011011111110110110001001111011
100000100010100110000101101011001
010011101100001001110000010010011
110100010100010101110010010001010
111001010000100110110101000100100
100011011000100101111100001000100
101011110101010100011101011111110
010101001111100110100100100001010
011111110100011001001000011000110
110011001100111011001100001100000
100111110001111101010011111100001
110100111010010000001101111010000
001100110001000101001110011000111
001111011000101011110101001000011
100011000100010100010011111110010
101000111010100101111011010000000
010001011111001010100101100111110
011100100010101001100001000010101
101100010110001011001101110111100
010100111100001110111111111110111
001011001101000111111010000001111
000111101111110110000110101000000
